# # # # # # # # # # # # # #
# # # S # # # # # # . # # #
# # # . # # . . . . . # # #
# . . . . . . # . . . . . #  
# . # # # . # # . # . # . #
# . # . # . # # . # . # . #
# # # . # # # # . # . # . #
# . . . . . . . . . . . . #
# . # # # # . # # # . # # #
# . # # # # . # # # # # # #
# . . . # # . # # # . # # #
# # # . # . # # # # . # # #
# . . . . . . # . . . . . #  
# . # # # . # # . # . # . #
# . # . # . # # . # F # . #
# . # . # . # # . # # # . #
# . . . . . . . . . . . . #
# # # # # # # # # # # # # #